行動を代わる	に を	知的行動を 人間に
判断をする	を	推論判断を
処理を用いる	を	記号処理を
記述をする	と を	記述を 主体と
注目を集める	が を	その後 サポートベクターマシンが
経験を行う	に を	経験を 元に
学習を行う	に を	経験を 元に
流行を超える	を	流行を
学習を繰り返す	を	学習を
学習をする	で に は を を通して	ACT-Rでは 推論ルールを 統計的学習を 元に 生成規則を通して
進化を見せる	て において は を	特に 敵対的生成ネットワークは 加えて 生成技術において
生成を行う	を	コンテンツ生成を
開発を行う	は を	エイダ・ラブレスは 開発を
テストをする	を	テストを
処理を行う	を	適用し
処理を行う	に により を	ティム・バーナーズリーにより Webに 知的処理を
意味をする	に を	データに 意味を
処理を行う	て に を	付加して コンピュータに 知的処理を
研究を進める	て を	費やして 研究を
命令をする	で を	命令を 直接
運転をする	に を	増やし 元に
特許をする	が に まで を	2018年までに 日本が 特許を
研究をする	を	研究を
運転をする	て に を	基づいて 柔軟に 運転を
注目を集める	から は を	ことから ファジィは 関わらず
制御をする	を	ニューロファジィ制御を
成功を受ける	を	成功を
制御を用いる	て も を	受けて 他社も 知的制御を
制御をする	から を	少なさから 制御を
制御をする	を	知的制御を
進歩を担う	を	進歩を
改善を果たす	が で に を	2012年に 画像処理コンテストで チームが 精度改善を
プログラムを使う	を	専用プログラムを
研究を続ける	が て を	ジェフホーキンスが 向けて 研究を
)をする	に は を	8月には 記号接地問題(シンボルグラウンディング問題)を
注目を集める	に を	急速に 注目を
普及を受ける	を	普及を
学習を組み合わせる	を	機械学習を
投資を行う	で に を	全世界的に 民間企業主導で 投資を
探索を行う	で を	実装し 無報酬で
推論をする	て を	推論を 経て
研究を始める	とも を	マックスプランク研究所とも 共同研究を
研究を行う	は を	Googleは 研究を
開発をする	で は を	中国では 立ち上げ 官民一体で
実験をする	を	実験を
開発をする	で を	日本で 研究開発を
投資をする	に は まで を	韓国は 2022年までに 投資を
学習をする	を	深層学習を
シミュレーションを行う	を	脳シミュレーションを
反乱を起こす	て に対して を	於いて 人間に対して 反乱を
弾圧を併せ持つ	を	弾圧を
監視を行う	に まで を	推し進められ 歩行者まで 監視を
手続きを経る	を	ウイグル族を
差別を認める	を	差別を
研究をする	を	研究を
展開を変える	を	展開を
戦争をする	を	戦争を
制御をする	は を	AIプログラムは ファジィ制御を
判断を介す	から を	観点から 判断を
禁止を求める	が に は を	4月には ヒューマン・ライツ・ウォッチが 禁止を
運用をめぐる	を	運用を
競争を行う	は を をめぐって	米国中国ロシアは 開発競争を 軍事利用をめぐって
記録をする	を	記録を
試験を行う	を	試験を
追及を受ける	て で と とともに は を	暴露されており 公聴会では とともに 拒否すると 整合性で 追及を
研究をする	が を	Microsoftが 共同研究を
解任をする	て は を	しかし 含まれており Google社員らは
解散をする	が で は を	4月4日 Googleは 倫理委員会が 理由で
存在を見いだす	に を	ものに 霊的存在を
)」をする	は を	アンソニーレバンドウスキーは 2017年
実現をする	を	実現を
話をする	は ば を	よれば 哲学者は みんな
疎通を行う	を	意思疎通を
勘違いをする	を	勘違いを
議論を行う	で は まで を	対談で 須藤は これまで けっこう
