行動を代わる	に	人間に
記述をする	と	主体と
注目を集める	が	ある
経験を行う	に を	元に 学習を
学習を行う	に を	元に 経験を
推論をする	て で に は を	なされている ACT-Rでは 生成規則を通して 統計的学習を 元に
統計をする	て で に は を	なされている ACT-Rでは 生成規則を通して 推論ルールを 元に
進化を見せる	て て において は	敵対的生成ネットワークは 活躍している 加えて 特に
計算をする	は	機械論
開発を行う	は	製作した
プログラミングをする	は	作り出した
プログラミングをする	は	示した
専用をする	に は	1992年に IBMは
投資を上回る	が	使い
意味をする	から に対して	ここから 非構造化データに対して
処理を行う	に に により	Webに 同年に ティム・バーナーズリーにより
意味をする	に	データに
処理を行う	て に	付加して コンピュータに
研究を進める	て	費やして
命令をする	で	直接
運転をする	に	増やし
特許をする	に まで	日本が 2018年までに
運転をする	て に	基づいて 柔軟に
注目を集める	から は	世界初であった ことから
制御を用いる	て も	受けて 他社も
制御をする	から	少なさから
改善を果たす	が で に	チームが 画像処理コンテストで 2012年に
研究を続ける	が て	ジェフ・ホーキンスが 向けて
行動を用いる	て は は	登場している これは ものではなく
ショットをする	が	データが
接地をする	に	8月には
注目を集める	に	急速に
投資を行う	で に	民間企業主導で 全世界的に
探索を行う	で	実装し
推論をする	て	経て
共同を始める	とも は	マックスプランク研究所とも Googleは
研究を行う	て	いう
研究をする	て で	行っている 立ち上げ
研究をする	で	日本で
投資をする	に は まで	2022年までに 方向 韓国は
反乱を起こす	て に対して	於いて 人間に対して
監視を行う	に まで	歩行者まで 推し進められ
手続きを経る	を	ウイグル族を
監視をする	に は	世界各国に 中国は
制御をする	は	AIプログラムは
判断を介す	から	観点から
開発を出す	に	2012年に
禁止を求める	が に は	ヒューマン・ライツ・ウォッチが 記された 4月には
開発を行う	は をめぐって	盛り込まれなかった 米国中国ロシアは
追及を受ける	て で で と とともに は	なった 整合性で 暴露されており 拒否すると とともに 公聴会では
共同をする	が	Microsoftが
監視をする	が によって	中国が AIによって
攻撃をする	で に	中東で 大量に
解任をする	て は	発表した しかし
解散をする	が で	倫理委員会が 理由で
存在を見いだす	に	ものに
話をする	は	哲学者は
議論を行う	まで	これまで
