注目を集める	が を	ある その後 サポートベクターマシンが
経験を行う	に を	元に 学習を
学習を行う	に を	元に 経験を
進化を見せる	て において は を	加えて 敵対的生成ネットワークは 活躍している 特に 生成技術において
進化をいる	て において は を	加えて 敵対的生成ネットワークは 活躍している 特に 生成技術において
開発を行う	は を	エイダ・ラブレスは 製作した
命令をする	で を	機構で 直接
運転をする	に を	元に 増やし
特許をする	が に まで を	2018年までに 日本が
特許をいる	が に まで を	2018年までに 日本が
運転をする	て に を	基づいて 柔軟に
注目を集める	から は を	ことから ファジィは 世界初であった 関わらず
制御をする	から を	多少 少なさから
研究を続ける	が て を	ジェフホーキンスが 向けて
研究をいる	が て を	ジェフホーキンスが 向けて
投資を行う	で に を	全世界的に 民間企業主導で
探索を行う	で を	実装し 無報酬で
研究を行う	て を	いう 始めており
研究をいる	て を	いう 始めており
投資をする	に は まで を	2022年までに 韓国は
反乱を起こす	て に対して を	人間に対して 於いて
監視を行う	に まで を	人工知能に 推し進められ 歩行者まで
監視をせる	に まで を	人工知能に 推し進められ 歩行者まで
禁止を求める	が に は を	4月には ヒューマン・ライツ・ウォッチが 記された
禁止をいる	が に は を	4月には ヒューマン・ライツ・ウォッチが 記された
追及を受ける	て で と とともに は を	とともに なった 公聴会では 拒否すると 整合性で 暴露されており
解任をする	て は を	Google社員らは しかし 含まれており 発表した
解散をする	が で は を	4月4日 Googleは 倫理委員会が 理由で 要請した
話をする	は を	みんな 哲学者は
話をいる	は を	みんな 哲学者は
議論を行う	まで を	けっこう これまで 長時間
議論をくる	まで を	けっこう これまで 長時間
